.........................................................................................................................................................................................@
.........................................................................................................................................................................................@
.........................................................................................................................................................................................@
.........................................................................................................................................................................................@
.........................................................................................................................................................................................@
.........................................................................................................................................................................................@
.........................................................................................................................................................................................@
.........................................................................................................................................................................................@
.........................................................................................................................................................................................@
.........................................................................................................................................................................................@
............................................................................C.####!......................................................................................................@
.............................!..................C..................!.......##########........!............................................!..!.........!##!..............................@
...............!.....!....######!.........!..........!..........################################!..........!.C..........!#...........!############################.......!...............@
#########################################################################################################################################################################################@
#########################################################################################################################################################################################@