........................................................................................................................................................................@
........................................................................................................................................................................@
........................................................................................................................................................................@
........................................................................................................................................................................@
........................................................................................................................................................................@
........................................................................................................................................................................@
........................................................................................................................................................................@
........................................................................................................................................................................@
........................................................................................................................................................................@
........................................................................................................................................................................@
........................................................................................................................................................................@
....................................................................#####...............................................................!...............................@
..................####...........!..........!..........################################...........C..........!..............###########################.................@
########################################################################################################################################################################@
########################################################################################################################################################################@