.......................................................................................................................................................................................@
.......................................................................................................................................................................................@
.......................................................................................................................................................................................@
.......................................................................................................................................................................................@
.......................................................................................................................................................................................@
.......................................................................................................................................................................................@
.......................................................................................................................................................................................@
.......................................................................................................................................................................................@
.......................................................................................................................................................................................@
.......................................................................................................................................................................................@
..........................................................................C.####!......................................................................................................@
...........................!..................C..................!.......##########........!............................................!..!.........!##!..............................@
.............!.....!....######!.........!..........!..........################################!..........!.C..........!#...........!############################.......!...............@
#######################################################################################################################################################################################@
#######################################################################################################################################################################################@