......................................................................................................
......................................................................................................
......................................................................................................
......................................................................................................
......................................................................................................
............................................###!......................................................
............................!...........#############......................!..........................
..............!.....!....#######.....#####################!.....!....!#########!........!#............
######################################################################################################