.........................................................................................................................................................................................@
.........................................................................................................................................................................................@
.........................................................................................................................................................................................@
.........................................................................................................................................................................................@
.........................................................................................................................................................................................@
.........................................................................................................................................................................................@
.........................................................................................................................................................................................@
.........................................................................................................................................................................................@
.........................................................................................................................................................................................@
.........................................................................................................................................................................................@
..............................................................................####!......................................................................................................@
.............................!.................G..................!.......##########........!............................................!..!.........!##!..............................@
...............!.....!....######!....C....!.........!..........################################!..........!............!#...........!############################.......!...............@
#########################################################################################################################################################################################@
#########################################################################################################################################################################################@