...................................................................................
...................................................................................
...................................................................................
...................................................................................
...................................................................................
...................................................................................
...................................................................................
...................................................................................
...................................................................................
...................................................................................
...................................................................................
.......##....................##....................................................
..@...####...........!!...#####....................................................
###################################################################################
###################################################################################
