..........................................................................................................
..........................................................................................................
..........................................................................................................
..........................................................................................................
..........................................................................................................
................................................###!......................................................
..............................!............#############.......................!..........................
..............!.....!.....#######......#####################!......!.....!#########!........!#............
##########################################################################################################