................................
................................
................................
................................
................................
................................
..@........####.................
################################