.......................................................................................
.......................................................................................
.......................................................................................
.......................................................................................
.......................................................................................
......................................###!.............................................
........................!.........#############....................!...................
...........!....!....#######...#####################!....!..!#########!......!#........
#######################################################################################