.......................................................................................................................................................................
.......................................................................................................................................................................
.......................................................................................................................................................................
.......................................................................................................................................................................
.......................................................................................................................................................................
.......................................................................................................................................................................
....................................................................#####..............................................................!...............................
..................####...........!..........!..........################################.....................!..............###########################.................
#######################################################################################################################################################################