.........................................................................................................................................................................................@
.........................................................................................................................................................................................@
.........................................................................................................................................................................................@
.........................................................................................................................................................................................@
.........................................................................................................................................................................................@
.........................................................................................................................................................................................@
.........................................................................................................................................................................................@
.........................................................................................................................................................................................@
.........................................................................................................................................................................................@
.........................................................................................................................................................................................@
..............................................................................####!......................................................................................................@
.............................!..................C..................!.......##########........!............................................!..!.........!##!..............................@
...............!.....!....######!....C....!..........!..........################################!..........!............!#...........!############################.......!...............@
#########################################################################################################################################################################################@
#########################################################################################################################################################################################@