................................
................................
................................
................................
................................
................................
..@.............................
################################