...................................................................................
...................................................................................
...................................................................................
...................................................................................
...................................................................................
.......##....................##....................................................
@.....####...........!!...#####....................................................
###################################################################################