.........................................................................................................................................................................................@
.........................................................................................................................................................................................@
.........................................................................................................................................................................................@
.........................................................................................................................................................................................@
.........................................................................................................................................................................................@
.........................................................................................................................................................................................@
.........................................................................................................................................................................................@
.........................................................................................................................................................................................@
.........................................................................................................................................................................................@
.........................................................................................................................................................................................@
..............................................................................####!......................................................................................................@
.............................!.................G..................!.......##########........!............................................!............!##!...............................@
...............!.....!....######!....C....!.........!..........################################!..........!............!#...........!############################.......!................@
#########################################################################################################################################################################################@
#########################################################################################################################################################################################@