..............@
..............@
..............@
..............@
......F.......@
..............@
##############@