...................................................@
...................................................@
...................................................@
...................................................@
...................................................@
...................................................@
...................................................@
...................................................@
...................................................@
..............#....................................@
............#.#....................................@
..........#.#.#....................................@
###################################################@
###################################################@